On	KEYWORD2
Off	KEYWORD2
Read	KEYWORD2
State 	KEYWORD2
Blink	KEYWORD2
MultiplyBlink 	KEYWORD2
Start	KEYWORD2
ReadInt	KEYWORD2
ReadFloat	KEYWORD2
BUFFER_EMPTY	KEYWORD1
BUFFER_FULL	KEYWORD1
BUFFER_OK	KEYWORD1
DPL_DigitalPins	KEYWORD1
DPL_SerialPort	KEYWORD1
LEDBOARD	KEYWORD1
BoardLEDOn	KEYWORD2
BoardLEDOff	KEYWORD2
S	KEYWORD1
NEW_LINE	KEYWORD1
LINE	KEYWORD1
Out	KEYWORD2